8 8
0 1 1 0 2 0 1 1
0 0 0 0 0 0 0 2
0 0 1 0 0 0 4 0
0 0 0 1 0 0 0 0 
0 0 4 4 -1 0 0 0
0 0 5 6 -1 0 0 3
0 0 0 4 -1 0 3 0
4 4 4 4 -1 0 0 2