18 18
0 0 0 0 2 0 0 0 0 0 0 0 0 0 -1 -1 0 0
0 0 0 0 0 -1 -1 0 0 0 0 0 0 0 0 0 0 0
1 1 1 0 0 -1 -1 0 0 1 3 0 -1 -1 0 0 0 0
1 1 1 0 0 0 0 0 0 0 2 0 0 0 0 0 2 0 
1 1 1 0 1 0 3 3 3 0 0 0 0 0 0
1 1 1 0 0 0 0 0 -1 -1 -1 0 0 0 0 0 2 4 
2 2 2 0 6 0 3 0 0 2 0 0 0 0 0 0 0 0
2 2 2 0 0 0 0 0 2 0 0 0 0 0 0 0 0 0
2 2 1 -1 -1 -1 0 0 0 0 0 0 0 0 0 0 0 0 
2 2 2 0 0 -1 -1 0 0 0 2 0 0 3 0 0 0 0
2 2 0 0 0 0 0 0 0 0 0 0 0 0 0 0 0 0
2 2 0 0 0 0 0 0 0 2 2 2 0 0 0 0 0 0
-1 0 0 0 0 0 0 0 4 0 0 -1 0 -1 0 0 0 0 
4 0 -1 0 0 0 0 0 0 0 0 -1 0 5 -1 0 0 0
0 0 0 0 0 0 0 2 1 2 2 2 2 0 0 0 0 0 

